NO /home/vboxuser/Desktop/cubo3d/textures/test_texture.xpm
SO ./textures/test_texture.xpm
WE ./textures/test_texture.xpm
EA /home/vboxuser/Desktop/cubo3d/textures/test_texture.xpm
S ./textures/test_texture.xpm
F 220,100,0
C 225,30,0

1111111111111
1001011
101001
1100N1
111111