SO ./textures/ex1/texture_SO.xpm
NO ./textures/ex1/texture_NO.xpm
WE ./textures/ex1/texture_WE.xpm
EA ./textures/ex1/texture_EA.xpm
F 220,100,0
C 55,99,199

1111111111111
1001011
10001001
1100W01
111111
111111111
111111111
11111111
111111111