NO ./textures/ex1/texture_NO.xpm
SO ./textures/ex1/texture_SO.xpm
WE ./textures/ex1/texture_WE.xpm
EA ./textures/ex1/texture_EA.xpm
F 220,100,0
C 55,99,199

1111111111111
1001011
1000101
11000S1
111111