NO /home/vboxuser/Desktop/cubo3d/textures/texture_NO.xpm
SO ./textures/texture_SO.xpm
WE ./textures/texture_WE.xpm
EA /home/vboxuser/Desktop/cubo3d/textures/texture_EA.xpm
F 220,100,0
C 0,0,0

1111111111111
1001011
101001
1100N1
111111